唵室哩迦理也抳麼賀帝惹(一) => om̐ tāriṇyai namaḥ
路迦馱怛哩摩賀野捨(二) => om̐ taralāyai namaḥ
薩囉娑嚩底(三) => om̐ tanvyai namaḥ
尾娑洛乞史(四) => om̐ tārāyai namaḥ
鉢囉枳穰(五) => om̐ taruṇa-vallaryai namaḥ
室哩(六) => om̐ tīra-rūpāyai namaḥ
沒地(七) => om̐ taryai namaḥ
嚩哩達寧(八) => om̐ śyāmāyai namaḥ
地哩底那(九) => om̐ tanu-kṣīṇa-payodharāyai namaḥ
補瑟致那(十) => om̐ turīyāyai namaḥ
娑嚩賀(十一) => om̐ tarunāyai namaḥ
唵迦囉(十二) => om̐ tīvra-gamanāyai namaḥ
迦麼嚕弭抳(十三) => om̐ nīla-vāhinyai namaḥ
薩嚩薩怛嚩呬姤儞喻訖哆(十四) => om̐ ugra-tārāyai namaḥ
僧㜸囉謨多囉抳(十五) => om̐ jayāyai namaḥ
惹野(十六) => om̐ caṇḍyai namaḥ
鉢囉枳穰播囉蜜哆禰尾曳(十七) => om̐ śrīmad-ekajaṭā-śirāyai namaḥ
阿哩野哆囉(十八) => om̐ taruṇyai namaḥ
麼努囉麼(十九) => om̐ śāmbhavyai namaḥ
嫰努鼻(二十) => om̐ chinna-bhālāyai namaḥ
商企儞(二十一) => om̐ bhadra-tāriṇyai namaḥ
布囉拏(二十二) => om̐ ugrāyai namaḥ
尾儞也囉倪以(二十三) => om̐ ugra-prabhāyai namaḥ
跛哩琰嚩那(二十四) => om̐ nīlāyai namaḥ
贊捺囉曩曩(二十五) => om̐ kṛṣṇāyai namaḥ
麼賀矯哩(二十六) => om̐ nīla-sarasvatyai namaḥ
阿爾哆(二十七) => om̐ dvitīyāyai namaḥ
比哆嚩薩娑(二十八) => om̐ śobhanāyai namaḥ
麼賀麼野(二十九) => om̐ nityāyai namaḥ
麼賀濕吠哆(三十) => om̐ navīnāyai namaḥ
麼賀末攞跛囉訖囉麼(三十一) => om̐ nitya-nūtanāyai namaḥ
麼賀嚕捺囉(三十二) => om̐ caṇḍikāyai namaḥ
麼賀贊拏(三十三) => om̐ vijay-ārādhyāyai namaḥ
訥瑟吒薩怛嚩儞素那儞(三十四) => om̐ devyai namaḥ
鉢囉散哆(三十五) => om̐ gagana-vāhinyai namaḥ
散哆嚕播左(三十六) => om̐ aṭṭa-hāsyāyai namaḥ
尾惹野(三十七) => om̐ karālāsyāyai namaḥ
入嚩攞曩鉢囉婆(三十八) => om̐ carāsyāyai namaḥ
尾儞喻囉麼理(三十九) => om̐ aditi-pūjitāyai namaḥ
特嚩𠰒(四十) => om̐ saguṇāyai namaḥ
商企(四十一) => om̐ asaguṇāyai namaḥ
伽匿藝(四十二) => om̐ ārādhyāyai namaḥ
作訖哩(四十三) => om̐ harīndra-deva-pūjitāyai namaḥ
達弩囉達囉(四十四) => om̐ rakta-priyāyai namaḥ
染婆儞(四十五) => om̐ raktākṣyai namaḥ
薩檐婆儞(四十六) => om̐ rudhirāsya-vibhūṣitāyai namaḥ
迦理(四十七) => om̐ bali-priyāyai namaḥ
迦攞囉怛哩(四十八) => om̐ bali-ratāyai namaḥ
儞捨拶哩(四十九) => om̐ durdhāyai namaḥ
囉乞灑枲(五十) => om̐ balavatyai namaḥ
謨賀儞(五十一) => om̐ balāyai namaḥ
散底(五十二) => om̐ bala-priyāyai namaḥ
建哆哩(五十三) => om̐ bala-ratāyai namaḥ
捺囉尾膩(五十四) => om̐ balarāma-prapūjitāyai namaḥ
戍婆(五十五) => om̐ ardha-keśeśvaryai namaḥ
沒囉憾麼抳(五十六) => om̐ keśāyai namaḥ
吠那麼哆左(五十七) => om̐ keśavāyai namaḥ
噳呬攞(五十八) => om̐ savi-bhūṣitāyai namaḥ
噳賀嚩悉儞(五十九) => om̐ padma-mālayai namaḥ
蟒㜸理也(六十) => om̐ padmākṣyai namaḥ
商迦哩(六十一) => om̐ kāmākhyāyai namaḥ
燥弭也(六十二) => om̐ giri-nandinyai namaḥ
惹哆吠那(六十三) => om̐ dakṣiṇāyai namaḥ
麼努惹嚩(六十四) => om̐ dakṣāyai namaḥ
迦播理儞(六十五) => om̐ dakṣajāyai namaḥ
麼賀禰尾(六十六) => om̐ dakṣiṇe-ratāyai namaḥ
散地野(六十七) => om̐ vajra-puśpa-priyāyai namaḥ
薩怛野(六十八) => om̐ rakta-priyāyai namaḥ
跛囉𠰒哆(六十九) => om̐ kusuma-bhūṣitāyai namaḥ
娑囉他嚩賀訖哩播尾瑟吒(七十) => om̐ māheśvaryai namaḥ
曩瑟吒麼囉誐鉢囉那哩捨儞(七十一) => om̐ mahādeva-priyāyai namaḥ
嚩囉那(七十二) => om̐ pañca-vibhūṣitāyai namaḥ
捨薩儞(七十三) => om̐ iḍāyai namaḥ
捨悉怛哩(七十四) => om̐ pingalāyai namaḥ
悉怛哩嚕播(七十五) => om̐ suṣumnā-prāṇa-rūpiṇyai namaḥ
蜜哩哆尾訖囉麼(七十六) => om̐ gāndharyai namaḥ
奢嚩哩(七十七) => om̐ pañcamyai namaḥ
喻藝儞(七十八) => om̐ pañcānanādi-paripūjitāyai namaḥ
悉馱(七十九) => om̐ tathya-vidyāyai namaḥ
贊拏理(八十) => om̐ tathya-rūpāyai namaḥ
阿弭哆度嚕嚩(八十一) => om̐ tathya-mārg-ānusāriṇyai namaḥ
歎抳也(八十二) => om̐ tattva-priyāyai namaḥ
奔抳也(八十三) => om̐ tattva-rūpāyai namaḥ
麼賀婆誐(八十四) => om̐ tattva-jñānātmikāyai namaḥ
素婆誐(八十五) => om̐ anaghāyai namaḥ
畢哩野捺哩捨曩(八十六) => om̐ tāṇdavā-cāra-santuṣtāyai namaḥ
訖哩怛哆(八十七) => om̐ tāṇdava-priyakārinyai namaḥ
怛囉薩儞(八十八) => om̐ tāla-nāda-ratāyai namaḥ
擗麼(八十九) => om̐ krūra-tāpinyai namaḥ
塢㜸囉塢㜸囉(九十) => om̐ taraṇi-prabhāyai namaḥ
麼賀哆播(九十一) => om̐ trapā-yuktāyai namaḥ
惹誐禰迦(九十二) => om̐ trapā-muktāyai namaḥ
呬姤禰喻訖哆(九十三) => om̐ tarpitāyai namaḥ
薩囉抳也婆訖底嚩怛娑攞(九十四) => om̐ tṛpti-kāriṇyai namaḥ
嚩藝濕嚩哩(九十五) => om̐ tāruṇya-bhāva-santuṣṭāyai namaḥ
失嚩(九十六) => om̐ śakti-bhakt-ānurāgiṇyai namaḥ
素乞瑟麼(九十七) => om̐ śiv-āsaktāyai namaḥ
儞底也薩嚩怛囉惹努惹(九十八) => om̐ śiva-ratyai namaḥ
薩嚩囉他娑達寧(九十九) => om̐ śiva-bhakti-parāyaṇāyai namaḥ
跋捺囉(一百) => om̐ tāmra-dyutyai namaḥ
噳悉怛哩(一百一) => om̐ tāmra-rāgāyai namaḥ
馱怛哩(一百二) => om̐ tāmra-pātra-prabhodhinyai namaḥ
達難那娜(一百三) => om̐ balabhadra-prema-ratāyai namaḥ
阿婆野(一百四) => om̐ bali-bhujyai namaḥ
矯哆弭(一百五) => om̐ bali-kalpinyai namaḥ
奔抳也(一百六) => om̐ rāma-rūpāyai namaḥ
室哩𤚥(一百七) => om̐ rāma-śaktyai namaḥ
路計濕嚩囉麼祖底(一百八) => om̐ rāma-rūp-ānurāgiṇyai namaḥ